BBBBBBBBBBB
B         B
B         B
B         B
B   B B   B
B         B
B    C    B
B         B
B    C    B
B         B
BBBBBBBBBBB